####################
#                 %#
# =     =     =    #
#                  #
#                  #
# .............  = #
#             .    #
#             .    #
#             .    #
#             .    #
#             .    #
#    o        .  = #
#             .    #
#             .    #
# o     o     .    #
#             .    #
#             .    #
# \  o        .  = #
#                  #
####################
