#################################
#.....#.#.#.#.....#=............#
###.###.#.#.#.###.#.#####.#.###.#
#.....#.#.#...#.#.#.....#.....#.#
#.#.###.#.#.###.#.#.#.###.###.###
#.#.....#...#...#...#.....#.....#
###.###.###.#.#.#.#.#.#.#.###.###
#...........#.#.oo..........#...#
#.#####.#.#.###.#.#.#.###.#.#.###
#.......#.#.....#...#.#.....#...#
###.#.#.###.#.#####.#.#.#.#.#.###
#...#.\.....#...#...#.#...#.....#
#.#.###.#.###.###.#.#######.#####
#.#.#.#.#.....o...#.....#.....#.#
#.#.#.#.#.#.###.#.###.#####.#.#.#
#.#.....#...#.....#.#...#...#...#
###.#####.#.###.###.#.#.#.#.#.#.#
#...#.#...#...#...#...#.#.......#
###.#.#.#.#.###.#####.#.###.#.###
#.......#.........#...=.......#=#
###.#.#.#.###.#######.#.#.###.#.#
#.....#.....#...................#
#.#.###.#.#.#.#######.#######.#.#
#.#.#...#.#...#.............#...#
#####.#####.#.#####.###.###.#####
#.#.....#.#.#..%..........#.....#
#.#.#.###.#.###.###.#.###.###.###
#.......#.........#.....#...#...#
###.###.#.#.###.###.#.#.#.#.###.#
#...#.#...#.#.....#.=...o.#...#.#
#.#.#.#.#.#.#.###.#.###.###.###.#
#...#...#.....#.......#...o.#=..#
#################################
