###############
#\...........o#
#.###.###.###.#
#.# #.# #.# #.#
#.###.###.###.#
#.............#
#.###.###.###.#
#.# #.# #.# #.#
#.###.###.###.#
#.............#
#.###.###=###.#
#.# #.# #.# #.#
#.###.###.###.#
#o.....%.....=#
###############
