####################
##.....#.#...#.....#
#..#.#.....#...#.#.#
##...#.#.#.#.#.=.#.#
##.#...........#..##
#.%..#.##=#.##.##..#
#.##........#....#.#
#....#.#.#.#..#.##.#
#.##...#.#...#.....#
#..#.#.....#...##.##
#.#....##.#.#.#...##
#...#.#.#.......#..#
#.#...=...##.##...##
#...##.#.#....#.#..#
#.#.......#.#....#.#
#...#.#.#.....#.##.#
#.#.=.#..#.#.##.#..#
#.#.#...#....o....##
#...#.#.#.#.##.#.#.#
#.#..........#...#.#
#...#.#.#.#.#..#...#
#.##..........#..#.#
#.o..##.#o#.#...#..#
#.#.#.......#.#...##
#.....#.#.#...#.#..#
#.#.#.......#...##.#
#.#\##.#.##...#....#
#...........#.#.##.#
#.#.#.#.##.#.......#
#...........#.##.#.#
#.#.##.##.#......#.#
#....#.....#.##.#..#
#.##...##.##.#....##
#....#.#......#.#..#
##.#.=...##.#.#..#.#
#....#.##...#...##.#
#.#.##....#...#....#
#.#....##...#...##.#
#...##....#...#....#
####################
