########################################
#..........##........###...........#...#
#.#.##.#.#....##.#\#..#..##.#.#.##...#.#
#....#.....##.#.....#...#..........#.#.#
##.#...##.#.....#.#...#..#.##.#.#.##...#
#=..##......##.##...#..#.#......=.#..#.#
#.#....#.#.#...#..#.##.....#.#.##...#..#
#...##.......#...#.....##.##.##...#...##
#.#....##.##.#.##..#.#....#....o#.#.#..#
#..#.#.#......#...#..##.#...#.##....#.##
#.#......##.##..##.#=....#.#.....##....#
#...#.#.#o.....#...#.##.#....##=#...##.#
##.#.....#.#.#.#.#...#....#.#.#...#.##.#
#....#.#.........#.#...#.#......#......#
#.##....#.#.#.#.#....#...#.#.##...#.#.##
#....#.#.....##...##.#.#o..#.##.#......#
#.##.#...#.#.=..#........##.......#.##.#
#.#.#..#...#.#.##.#.#.#.#.%.##.#.#.....#
#.....#..#................#........#.#.#
########################################
