########################################
#..........##...##...#.#..o.#..#...#.#.#
#.#.#.##.#....#....#.....##...#..#.....#
#.#.#...\.#.#...##..#.#.##.##...#..##.##
#.....#.#..##.#...#..........#.#..#...##
#.##.#...#...o#.#...##.##.#.#....#..#..#
#.%#...#.##.#...#=#.....#.#.#.##...#.#.#
#.#..#.#....#.#.....#.#...=.....#.##...#
#.#.#...#.#...##.##...##.#.#.##...#..#.#
#.=...#...#.#..#..#.#..........#.#..#..#
#.#.#.##.#...#..#.....#.#.#.##.o#..#..##
#..........#..#..##.#........#.#..#.#..#
##.#.#.#.#..#..#......#.##.#.....#....##
#.....#...#..#...#.#.#......#.#.##.#.#.#
#.#.#...#...##.#.....##.#.#.......=....#
#.#..##...#......#.#....#..#.#.##.#.##.#
#..#....##..#.##.=..#.#...#..........#.#
##..##.##..##...#.#...#.#...#.##.#.##..#
###.......#...#.....#.....#...........##
########################################
