####################
#....#.....#...##.=#
#.##..#.#.#..#....##
#.#.#.......#..##..#
#..=.#.#.##.#.#..#.#
#.##..........%#...#
#...#.#.##.#.#...#.#
#=#............#.#.#
#..#.#.##.##.#.....#
##=.....#.#...#.##.#
##.##.#.....#...##.#
#...\...#.#...#....#
#.#.#.#...#.#...##.#
#......#.#....#....#
#.#.##.....##.#.#.##
#...#..#.#.....#...#
#.#..#....##.#..##.#
#..#..#.#.....#..#.#
##.##....#.##..#...#
#.....##.....#...#.#
#.#.#..#.#.#...#...#
#...##...#.#.#...#.#
#.#....#.......#.#.#
#...##.##.#.##..#..#
#.#=.....#.....#..##
#.##.##.#..##.##.#.#
#.........#...#....#
#.#.##.#.#..#..#.#.#
#......#...#.#.....#
#.#.##...#.o...#.#.#
#......#...#.#.#.o.#
##.#.#..#.#......#.#
#..#...#....#.#.#..#
#.#..#...##.#...#.##
#..#o..#......#....#
#.#..#..#.#.#...#.##
#...###.#.#...#....#
##.#.#.#....#...##.#
#........##...#....#
####################
