#####################
#...#...#.o.#...#...#
#.#.#.#.#.#.#.#.#.#.#
#.#...#...#...#...#.#
#.#################.#
#.......#...#.......#
#.#####.#.#...#####.#
#.......#.#.#.....#.#
#.#####.#.%...#.#...#
#.#o=...#.#.#.#.###.#
#.###.#.#.#.#...=o#.#
#...#.#.#.\.#.#####.#
#.#.....#.#.#.......#
#.#####...#.#.#####.#
#.......#...#.......#
#.#################.#
#.#...#...#...#...#.#
#.#.#.#.#.#.#.#.#.#.#
#...#...#.o.#...#...#
#####################
