############
#...#...#..#
#.#..##...##
#.o#..##.#.#
##..#..#o..#
###..#..#.##
##.#..#.%..#
#...#..##.##
#.#..#...\.#
#=##.#.#.#.#
#.....=....#
############
