######################
###...######.##.#=...#
#...##.#..........##.#
#.#.##.#.###.#.##.##.#
#.#......###.\.##....#
#...####.###.#.##.##.#
###.....o............#
#.#.##.#.###.#.##.##.#
#.#.##.#.###==....##.#
#......#.....#.###...#
#o####.#.#.#.#.###.#.#
#.#.=...%....#.......#
#.#.#.##.#.##.####.#.#
#.....##.#.##.####.#.#
###.#.##.#....####...#
###.#......##.####.#.#
#...#.##o##..........#
#.#.#.##....#.#.##.#.#
#.#.#...#.#.#.#.##.#.#
#.#.#.#.#.......##.#.#
#.........###.#...o..#
######################
