###############
##.#....##.o..#
#..=.##.%..##.#
#.##....##..#.#
#....#.#..#...#
#.#.#....#..#.#
#\...=#.##.##.#
##.#.##....#..#
#.......##...##
#.#.#.#....#..#
#o..#.#.##.#.##
#.#...........#
#..#.#.#.#.##.#
##............#
###############
