################################
###....#....................##.#
#...##...#.#.##.#.#.###.#.##.#.#
###.##.#.....##.#...###.#.##.#.#
###.##...#.#.##.#.#.###.#..=...#
###.####...#.##...#.......##.#.#
###.####.#.#.##.#.#.#.#.#.##...#
###.####.....##....\....#.##.#.#
###.####.#.#.####.#.#=#........#
###.................=.#.#.##.#.#
#####.#.#.##.##.#.###...o......#
#####.....##.##...###.#.#.#.##.#
#####.#.#.##.####.###.#.#.=.##.#
######....##.####.....#.#.#.##.#
######.##.##.####.###..........#
######.##.##..........#.###.##.#
#.........##.#.#.#.##.#.###....#
##.###.##.............#.###.##.#
##.###....#.##.###.##..........#
##.###.#.##.##........###.####.#
##.#........##.###.##.#........#
##.#o#.##.#.##.###.##.#.##.###.#
##...................oo.##.###.#
##.#.#.##.#.##.###.##.#.##.###.#
#....#......##.###.##.#.......=#
##.#.#.#.##.##.....##.#.##.#.#.#
#......#.##.##.###.............#
#.######.##.##.###.#.##.#.#.##.#
#....................##o.......#
##.###.#######.#.#.#.##.#.#.#.##
#....................%.........#
################################
