######################
#.##................##
#.###.#.#.#.#.#.##.###
#.###.#.#............#
#.....%...#.#.#.##.#.#
#.###.#.#.#.#.#.##...#
#.###.#.#.#.#.######.#
#.#..................#
#.#.#.#.##o#.####.##.#
#.................o..#
#.#.#.#.#.##.##.#.##.#
#..........=..o......#
###.#.#.##.#.##.#.##.#
###.#.#.##.#.##.#.##.#
#............##......#
######.###.#...###.#\#
######.###.#.#.###...#
######..o.....=#######
######.#=###.#.#######
######.#.###.#=#######
#######........#######
######################
