################################
#..#....%......#...##......#..##
##...#.#.#.#.#...#.##.##.#..#..#
#..#.#..#......#...#...#..#...##
#.#....#..#.#.##.#...#..#..##..#
#..#.#...##........#..#..#..#=##
##...#.#....#.#.##..#..#..#...##
##.#...##.#.##.....#..###..##.##
#..#.#....#.#..#.#...#...#.....#
#.#....##.....#..#.#...#...#.#.#
#...#.#..#.#.#.#...###..#.####.#
#.#...=.##.#.#...#.####........#
#...#.#.##...#.#...#...#.##.#.##
##.###...#.#.....#...#.#....#.##
##.##..#.....#.#.#.#.#...##...##
#.....#.#.#.#..........#....#..#
#.#.#.#.\=..#.#.#.#.#.##.##.##.#
#...#..#.##...#.##.......#.....#
##.#.#.#....#......##.#.#..#.#.#
#........##.#.##.#......##..#..#
#.#.#.##.##........##.#...#...##
#......#....#.#.##......#.##.#.#
##.###..#.#.......#.#.#......#.#
#.....#.....#.#.#......#.#.#...#
#.##.#.#.#.#..#...##.###.#.#.#.#
#........#...#..#.....#......###
#.#.##.#...#...##.#.#..#.#.#..##
#.#....#.#..##.......#...#...###
#...##.#.##..#.##.##...#.#.##.##
#.##...=####......##.#.#.......#
#....##..###.#.##........##.#.##
################################
