######################
#............#..#....#
#.#.#.#.#.##..#...#.##
#.....##.=..#...#....#
#o#.#....#.#..#..#\#.#
#....#.#.....#.#...o.#
#.#.#....#.#.....#.#.#
#.....#o#....#.#.....#
#.#.#.#...##...%#.#.##
#...##..#...#.#....=.#
#.#....##.#.....##.#.#
#.##.#.#...#.##....#.#
#.....#..#.....#.#...#
#.#.#...##.#.#.....#.#
#...##.#......#.#.##.#
#.#.....#.#.#.#.#.=o.#
#.#.#.#..........##.##
#.....##.#.#.#.#..#.##
##.##..........##....#
##....#.#=##.#..##.#.#
#..##.........#......#
######################
