####################################################################################################
#.......=.....#.....#...#.....##...####.#..#.................#..###....##..........#......##..#....#
#.###.##.##.#...###..##...#.#....#........#..#.#.#.#.##.#.##...#####.#.###.####.##...#.##.###...#.##
#...........#.#..###...#.#....##...#.#.##...#................#..####....#...###....#......#...#....#
#.#.#.#.#.#...##..##.#.....##.##.#.#.#.#..#...##.#.#.#.#.##.###..####.#...#.##..##...##.#...#..#.#.#
#.....##....#..##.....#.#.##...#........#...#.............####.#.####.#.#......####.##...#.##.#.#..#
##.##....#.#.#.#.#.##...#.#..#...##.#.#...#...#.#.#.#.#.#..#.....#.......#.#.#.####.#..#..........##
#..#..##...#.#........#.....#..#..#....##.#.#..#...##...##...###...#.#.#.#.....#.#....##.##.#.##.#.#
#.#..###.#....##.##.#.#.#.#.#.#.#...##..#...##...#....#...#.#....#.....#...#.#.....##..........#.#.#
##..###....##..#.##.....#...#.....#.###...#..#.#...##...#.....##..##.#...#...##.#.###.#.#.#.##.....#
#..#....##...#......#.#...#.#.#.#.......#..#...#.#..#.#.###.#....#.....#...#......#.#.#.#.....#.##.#
#.#.#.#..#.#...#.#.##...#.........#.#.#..#...#....#......##...##...#.#...#...##.#........#.##...##.#
#.......#....#.#....#.#.#.#.#.###.#.#.##..##...##...##.#....#.###.#....#.#.#....##.#.#.#......#....#
#.###.#...####..#.#...#........#........#....#.#..#....##.#.....#...##......###.#....#.#.#.#.#.#.#.#
#.##....#...###.....#...##.###...#.##.#..#.#.....###.#......#.#..#.#.#.#.##.##....##...........#...#
#....##.#.#.....#.#...#........#....#..#..##.#.#.#...##.#.#.####.......#.......#.#.##.#.#.#.##...#.#
##.#......##.##...#.#..#.#.#.##..##...###.........##........###..#.#.#...##.##......#.#.....#.#.##.#
#....##.#..#..#.#....#..#.......#.#.#..#..###.#.#..#.#.#.##.##..#......#.......##.#.#...#.#......#.#
#.##.#...#..#.....##..#..#.#.#.##....#.##........#.#.#.........##.#.##...#.##.#.......#...#.##.#...#
###....#..#..##.#...#..#.....#.#.#.#.#....##.#.#.#.....#.#.#.#....#....#....#...#.#.#...#...##...#.#
##..#.#..#.#......#...##.##.#......#.##.#......##..#.#.#......#.#...##.##.#..#.#......#...#....#...#
##.#..#.#....#.#.#..#.........#.##....#...#.##....##.....##.#.....#.#......#.#...##.#...#...##...#.#
#...#.....##.....#.##.#.##.#.##....#.#..#...###.#....#.#.....#.#.#....##.#.....#......#...#....#.#.#
#.#..##.#....#.#......#.##....##.#.#...##.#.#...##.#.....#.#.....#.##.....###.#.#.#.#.#.#...##.#...#
#..#..###.#.#...#.###....##.#........#........#..#.##.##....##.#......#.#.#.#.....#....###.#.....#.#
##..#..#......#.#.##..##..#.#.#.#.#.##.#.#.##.##.......#.##.....#.#.#.....=...#.#..#.#.....#.##.##.#
#.#...#..#.#.#.....#.####.......#....#...#..#.###.##.#.....##.#.....##.##.##.#.###..##.##.#..##....#
#...#...##...#.#.#....####.#.##...#.#..#...#...#.......#.#....##.##........#.#..###..#..#...#...##.#
#.#...#....#....#.#.#..###.#.#..##....#..#...#...#.#.###...##.....#.#.##.#....#..###..#...#...#..#.#
#...#..#.#...##....#..#.......#.#..##.##...#...#........#.####.#.#.....#...##..#...##...#.##.#.#...#
##.###.....##...#.#..#..#.#.#.....#......#...#...#.#.##....###.#...#.#...#..##...#..#.#.....##...#.#
##.#...#.#....#..#..#..#.....##.#...##.#...##..##.......#.#####..#.....#.##....#..#...##.##..#.#.#.#
#....#.....#.###...#..##.#.#......#...##.#....###.##.##.#.##....#..##.#...#.##..#...#......#..#....#
#.#.#..#.#.#.....##.#......##.#.#...#......##...#.##.........#.##.##....#......#.##.##.#.#...##.#.##
#.....#......#.#......##.#.......#.##.#.#.#..#.#.....#.#.#.#......#..##.##.##.##.....=....#.#......#
#.#.#...#.#.##..###.#.#....#.#.#....#.#.....##...#.#...#....#.#.#...#..........#.##.#.#.#..#..#.##.#
#.....##......#..#.....##.#.....#=#...#.#.#.#..####..#...###...#..#.#.#.#.#.##......#...##...#...#.#
#.#.#....#.##..#...#.#......#.#...#.#.#...#...#..#..##.#..#..#...#....#.#......##.#...#.##.#=..#...#
#....#.#.#...#...#.#...#.##...#.#...#...##..#.##...#....##..###.#..#.#...##.#.##....#..#.....#...#.#
##.#.#.....#...#.....#......#....#.#..#....##....#...##....####.#.#....#.........##..#..#.##.#.#...#
#......#.#...#..#.#.####.##.##.#...#.##.##....#.##.#....#.#####.....##..#.##.###..##..#...#......###
#.#.##....##...##...####.......#.#......#..#.#......#.#...#####.###...#.#.....#.#...#...#..#.#.#...#
#...#.#.#....#.#..#..##..##.##...#.##.##..##...##.#.....#..#.#...#..#.#...#.#.....#...#...#..#...#.#
#.#.......#.#....###....###.#..#.........#...#..#...##.#.#.....#...#....#...##.##.#.#.#.#...#..#...#
#...#.#.##...#.#.##..#.#......#.#.#.#.#.###.###...#......#.#####.#...##...#.##...........#.#.#.##.##
##.#.......#......#.#....#.##.#...##.....##.#...#...##.#..#####....#....#......#.#.##.#.#.......#.##
#...##.#.#...##.#...#.#.#...##..#....#.#......#...#.##..#..##...#.#..#.#..#.##...#.##.#...#.#.#....#
#.#........#.##...#.#.....#....#..##....#.#.#...#...###..#....#....#.#...#.....#...#....#.......##.#
##.#.#.#.#.#....#....=##.##.##...####.#......#.#..#.###.#..##...##.....#...#.##..#...##..#.#.#.#.#.#
#...........##.##.###..#....##.#..#.....##.#.....#...##.##.##.#...#.#.#..#......##.#..#.##.........#
#.##.##.###....#..###.#..##......#..#.#..#...##.#..#.......#....#..#....#.#.#.#.....#...#..#.#.###.#
#.#.........#.#..####..#..#.#.##...#...#...#..#.#.#..#.###...##..#...#.##...#...#.#...#...#........#
##..#.##.#.#....######.#.#.......#...#...#.##......#.......#..#.##.#......##..##...#.#..#...#.##.#.#
#..#..####...#.####........#.###.#.#...##...#.##.#...##.##..#......##.##.#...##..#....#.##.##.##...#
##...#=....#....#...##.##.#.#.##...#.#....#.#.....#.#.#.#.#..#.#.#........#.###.###.#............#.#
#..#...#.#..#=##..#............#.#....#.#....##.#.........##.......#.##.#.#.#....##.##.#.###.#.#...#
#.#.##.....#.....#..##.#.#.###.....##....#.#..#..#.#.##.#....##.#.#...#.##...#.#.....#...#.......#.#
#.#....##.#..##.#..#.#...#.##..#.#....#.#...#...##...#....##....#.#.#......#.#...###...#...#.##.#..#
#...#.#.#...###...#....#......#....##.....#..#.#...#...#.#.##.#.......#.###....#.....#...#........##
#.#.#.....#..##.#...#.#..#.##...##.##.#.#.##.#.#.#...##........#.#.##.#.##..#.#..#.#..##...#.##.#..#
#...##.##..#.#....#.....##....###.......#........#.#....#.#.##.#...........#...##...#....#.......#.#
##.##....#.....#.#..##.####.#.....##.#.#..#.#.#.#..#.#.##.#......#.#.#.###...#....####.#...##.#.#..#
##....#.###.##....###...#.....#.#.#..#...##.#.#...#..#......#.#.##.....##.##...#.######.##.......#.#
#..##..####.##.##.....#..#.#.##....#...#.#......#...#..#.##.#....##.##.......#.....#.......###.#...#
##.##.#.###.......##.###...#....##...#...#.#.#.#..#...#......#.#....##.#.#.#...#.#...##.##...#.#.#.#
##..........#.##.#=......#...##..#.#...##....#.##.#.#...##.#....#.#.#....#.#.#.....#..#....#.....#.#
#..#.#.##.#........##.#.#..#...#.....###..#.#.......#.#.....#.#.......##......#.##.#.#..#.#..###...#
#.##........##.#.#........##.#..#.#.#.###.#..#.#.#.#....#.#...#.#.#.#..##.#.#....#.....#....##.#.#.#
#.##.#.##.#........##.#.#.....#...#.#.......#...#....##....##...#...#.#......#.##..#.#...##........#
#...........#.#.##........#.#...#.#..##.##.#..#...#.#.#.##....#...#.....##.#...###..#..#.#..#.#.##.#
##.##.#.#.##....##.##.#.#.....#....#....#....#.#.#........#.#..#.#.#.#.###.#.#....#..#.##..#..#....#
#.......#....##.....#..##.##.#.#.#.##.#...#.#......#.#.#.##.##.....#.#.#....##.##..#......#.#...##.#
#.#.###...##....#.#..#....#.#.....###.#.#.....#.##............#.#.#......##.##.##.#..#.#.##...#.#..#
#...###.#.##.##.#..#..#.#....#.##......##.#.###.##.#.#.##.#.##......##.#.#...#....##.....#..#.#..#.#
#.#..##...........###.#...##...#..##.#......#........#.#..#....##.###......##..##....#.#...#....#..#
#..#....#.#.#.##.#.#....#..#.#...#.#.##.#.#..#.#.#.#....#.#.##....##..###.#...#...##.#...#...#.#..##
##...##...#...##.#...#.#.#.....#.....#.....#...#.....##.......#.#....#.#....#.#.#...###.#..#.#.#.#.#
#..#....#...#......#.......#.#..#.##...#.#...#...#.#..##.##.#....#.#.....#.#....#.#..#....#........#
##.##.#...#..#.#.#..##.#.#.....#.....#.....#...#....#..#..#.##.#.....#.##...#.#..#.#...##...#.#.##.#
##....##.#.#......#..#...#.#.#...#.#..#.#.##.#...##.##..#........#.#......#....#....##.#..#......#.#
#..##......#.##.####...##......#.#..#........#.#.#....#.#.#.#.#.#...#.#.#.##.#...##.....#..#.#.#...#
#.###.#.##...#...####.#.#.#.##....#...#.###.#..#...#.#............##...........#....#.#..#.......#.#
#.###......#...#...............#.###.#.......#...#.....###.#.##.#....##.##.#.#...##....#...##.##...#
#..##.#.##...#..#.##.#.#.#.#.#...##....#.#.#...#...##.#......#...#.#.........##.#.#.##...#...##..###
##.........#..#....#.....#..#..#..#.##...#.#.#...#.###.#.#.#...#...##.#.##.#...#......#.##.#..##.###
#..#.##.##..#..#.#.#.#.#..##..#.#.#....##......#.#..........#.#..#....#......#...#.#.##.....#......#
#.#.......#.##\........##....#.....##.#...#.##.#...#.##.#.#....###.##...##.#...#........#.#...#.##.#
#.#.#.#.#.....#.#.#.##.##.#.#..#.#......#......##.#...#....#.#.....###.##...##...#.#.#.##.##.##....#
#........##.#.................#...#.#.#..#.#.#......#.##.#.....#.#.....#..#....##....#.#...#..#.##.#
#.#.##.#......#.#.####.#.#.##.#.##...#..#..#...#.##......###.#.#.#.#.#...#.#.#.#..##....#.#..#.....#
#........##.#.#...###..#.#...#.....#..#...#..#.#....##.#.###..........##.........####.#.....#..#.#.#
#.###.##........#..###....##...#.#...#..#...##...##......##..#.##.#.#....##.#.#.#####...#.#...#....#
#.###....#.##.#..#..##.##...#.##...#...##.#....#.#..##.#..##.......#.#.#.#....#.#####.#..##.#.#.#.##
#.....##.......#...##.....#...#..#...#.#....#.#....#.#..#....#.#.#....#.#..##.....#.#..#......#...##
##.##....#.#.#...#....#.#..#.#..#..#.#...##.#.#.#.#....#..#.#......##.....##.#.##.....###.#.#...#..#
#...#.##..#..##.#..##....#.#...###.....#........#...#.###.....##.#...#.#.##....##.###.###....#.#.#.#
#.##...##..#......#..#.#.....#.###.#.#.#.###.#.#..#....#..##.#...#.#........##..#.##......##.....#.#
#....#...#.%##.#.#.#.####.#.##.###.......###...#.#.#.#...#.....#.#.##.#.###.###......#.#.#...##.#..#
#.#.###.###........=......#........#.#.#..#..#.........#...#.###.........#..####.#.#.......#......##
####################################################################################################
