######################
##....#...##=........#
#..##...#..#.#.##.##.#
#.#...#..#.......#.=.#
#...##.#...#.#.#..##.#
#.#......#.#....#....#
#...#.#.#....#.###.#.#
##.###...#.#...##..#.#
##.##..##...##.#.=#..#
#.....#...#..#..#...##
#.##.##.#...###...##.#
#..#....#.#.....#....#
##...##...##.##...##.#
#..#..#.#..#..#.#..#.#
#.#..#...#..#.....#..#
#...#..#..#..##.#...##
##.#..#=.#.#......#..#
#...#.#.#....#.#.###.#
#.#.......##.....###.#
#.%#.#.#.#.#.#.#\.#..#
##.............##...##
######################
