############
#...#..#..##
#.#.=#..#..#
#..#..#...##
##..#..##..#
###.\#..#.##
####..#=..##
#####..##.##
######.....#
######.#=#%#
#####..#...#
############
