######################
#...##..............o#
#.#.##.#.#.#.###.#.#.#
#..........#.#.......#
#.#.##\#.#.#.#.#.###.#
#.#o...#.#.#...#.###.#
#...##o#.#.#.#.......#
#.#.##.#.#.=...###=#.#
#.#........#.#.###...#
#.#.##.###...#.###.#.#
#..........#.#.......#
#.#.######.#.#.###.#.#
#...##...........o...#
#.####.###.##.##.#.#.#
#.####.###.##.##.....#
#...............#.####
###.#.#.#.#####...####
###.#.#=........#%####
###.....#.#####.#.####
###.#.#...#####.#.####
#.......#.......=.####
######################
