###############
#...o#........#
##.#...#.##.#.#
#....#=..##...#
#.##...#....#.#
#.o#.#=..##...#
##\....#..##.##
###.##..#..#.##
##.....#.#....#
#..#.#.#..#.#.#
#.#..#...#....#
#..#..##..#.#.#
##..#..%##...##
###...#....#..#
###############
