######################################################################################################################################################
#...#.....=##....##.#...........##.....##...........#....#.........####..#....##........##.....#.#..#...#.......###.###....#.###.#........#..##......#
#.#.#.##.#..#.##.#....##.##.#.#....#.#..#.#.#.#.#.#...##...#.#.#.#.####.###.#....#.##.#....#.#.....#..#...#.#.#......##.##.........#.##.#...###.##.#.#
#...#.##..#...#...#.#..#.#.....###...##.....#.......#....#..........#....#....##.#.#...##.#....##.#.#...#.......##.#..#.##.#.##.#.#.###...#..#...#...#
#.#......#.#.#..#.....#...#.##..##.#...#.#.#..#.###.#.##..=##.#.#.#...##...#.###....##....#.#.#..#....#...##.#.##..##......#......#.....#.##...#...#.#
#...#.#.#..#...###.#.#..#.#.###....#.#.......#...#....#..##........#.#.#.#...###.##...#.#.......###.#...#.......##....##.#...##.#...##.#.....#...#...#
#.#.#....#...#..#....#.#....##..##.....#.#.###.#...##...#.#.##.##.#........#...#..#.#.....##.#.#....#.#..#.#.##....##..#...#.#....#......#.#.##.##.#.#
#....#.#.#.#...##.##....#.#....#...#.#...#.###.#.#....#.............#.#.##...#...#....#.#.#......##.....##......#.####...#.....##...##.#...........#.#
#.##..#.....##.....#.##.....##.#.#.....#...##......##..###.#.#.#.#.#....##.#.#.#...##.#.#...##.#...#.#.#...#.#.##.###.#.#..#.#....#....#.##.##.#.#...#
#...#...#.#.##.#.#....##.##.#....#.#.##.##....##.#...#..#......#.#..#.#.....#..#.#.....##.#.#....#.....#.#...#.#...##.....#....##..##.##.##......#.#.#
#.#...#...#........##.#..#....##..#........#.##...##..#..#.#.#..###..###.##...#...##.#....#...##...#.#...#.#..#..#....#.#...##...#.......#..#.##.....#
#..##...#..##.#.##......#..##...#...##.#.###.#..#...#..#.....##....#........#...#.....#.#..#.#...#...#.#..#.#...#..#.#....#..#.#...#.#.#...#....##.#.#
##..#.##.#.........##.#.#.#...#..##.......#....##.#...#.#.##....#.#.#.##.##...##..#.#...##...##.#..#....#.....#...#....##...#....#.#....##...##......#
###........#.##.##.#..#...#.#..#....#.#.#...##.#..#.#........#.#....#.......#...=#....#..#.#....#.#..#.##.#.#...###.##..#.#...##....#.#....#.#..#.##.#
####.#.##.#...#.#...#...#...##..#.#.#.#...#....##.....##.#.#.....##...##.##...##...##.#.#..##.#.#...##......##.##...#..#....#...#.#.....#.##...#..#..#
###.....#..##...#.#...#...#....#........#...##....#.#........##.#...#.......#.#..#.#.....#.##.#...#.#..##.#.##....#..#...##.#.#.....#.#...###.#..##.##
##..#.#..#...##.....#...#...#.#..#.#.#.##.#...###...#.#.#.#.#.....#..#.#.#.#...#..#..#.#....#...#.#...#.#......##.##.#.#......##.##...#.#..##.#.#....#
#..#...#..##....#.#..#.#..#.....#...........#..#.##..#..#.....#.#.#.##...#...#..#...#...#.##..#.#...#....#.#.#......#....##.#..#..#.#....#..#....#.#.#
##...#.##....##.....##.##.##.#.#..#.#.##.##.##.....#...#..#.#..........##..#..#...#...#......#....##..##.......##.#...#.##...#..#.....##..#..#.##....#
#..#......#.##..#.#.#............#....#...#.###.#.###.#..#....##.##.#.#.#.###...#.##.#.#.#.#...##....#...#.#.#.....#.#.....#..#..##.#...#..#......##.#
#.##.#.#.#..#..#......#.#.##.#.#.##.#...#...............###.#...#............#.#..##.#.......#....##...#..##.#.#.#...#.##.#..#.#......#...##.#.#.##..#
#.#..#....#..##..#.#.#...............##..#.##.#.##.#.##.....#.#...##.#.#.#.#....#......##.##...##....#.##.#........#......#.#....#.#.#..#....#.#....##
#...#..#.###....#......#.##.#.#.##.#....#...#.#.......#.#.#.....#..#..#......#.#..#.##.......#...#.#...##...#.##.#.#.##.#.....##.......#.#.#...##.#..#
#.#..#...##..##...##.#.#.....##.#..#.#.#..#...#.#.#.#..##.#.#.#..#.#.#..#.##.....#.##..#.##.#..#.#..##....#...#.........##.##....##.##.#.....#....#.##
#.##..##....####.#..#....#.#..#...#..#..#.##.#.......#.........#......#..#...##.#.....##......#...#.#.#.#...#...###.#.#..#....##.##.#....#.#..##.#...#
#...#....##.#.#....#..###...#..##...##=#..#....#.##.#.##.#.###..#.#.##.#...#......#.#....#.##...##....#...#.#.#..#.....#...#.##.......##...##..#...#.#
##.###.#........##...####.#.##....#.....#..###...........#...##.#......###.#.#.##...##.#..#.#.#....#.#..#..#...#...#.#...#...#..#.#.###..#...#...#.#.#
#..##..##.###.#....#..##..#.#..#.#..#.#..#.....###.#.#.#...#..#...##.#.##.......#.#..#..#.......##.....#.#...#...#....##...#...##.#..###...#...#.....#
#.####.........#.#..#....#...#.....##.##.#.#.#.....#.#...#..#...#.........#.#.#....#..#...##.#.##.#.##.#.#.##.#.#..##....#...#......####.#...#...#.#.#
#...##.#.#.#.#....#..#.#...#...#.#.#...........#.#.....#...##.#...#.#.#.#......#.#..#...#..#...#...........#......######...#...#.#.#.#...#.#...#...#.#
###.....##...#.#.###...#.#.#.#.##....##.#.##.###.#.#.#...#.#...##.#...#.##.#.#....#...#..#...#...#.##.#.#.#..#.#.#######.#.#.#.###.....#...#.##..#..##
##..#.#....##.#...#..#..##.....#..#.#......#.#.....#.#.#..##.#..#...#........##.##..#..#.#.#.##.#.....##...#.....###.....#..##..#..#.###.#...###.##..#
#..#..##.#......#.##.##....##.#.=#..#.##.##....#.#.....##..#...#..#...##.#.#.##....###............#.#....##..###..#..#.#..#...#...#......#.#..##...#.#
##...##....#.#.##.......#.###.#.#..#........#.##...###...#...#...###.#.#.#....#.##.....##.#.##.#.#....#.#...###.#...#...#...#.#.#...#.#.#...#....#...#
###.#...#.#.......##.##....##.....##.#.#.#.#..#..##....#...#...#.........#.###.....#.#.......#.##..#.#..##.#.#..##.#..#...#......#.##....##..#.#.#.#.#
#.#.####.#..#.#.#....#..#.#...#.#.#..........#..#...#.#..#..#.##.##.##.#....#..##.##..#.#.#.#.....#...#.......#.#....#.#.#..##.#...#..##....##.=...#.#
#....###...#.....#.#...#....#.......#.#.#.#.#..##.#...#.#.#...#........#.##...###.#..##...#...##.#..#...#.#.#.....##...#...#.....#...#..#.#....#.#...#
##.#.##.#.##.#.#...###...#.###.#.##...#.#....#......#.......#...#.#.##......#..#....#...#...#....#.#..#.......###...##...#.#.###...#...#....#.#....#.#
##.............#.#.#...#......##.####.....##...##.#.#.#.###...#...#....##.#.#.#..#.#..#...#.#.##...##..#.##.#####.#...#.#..#..#..#...#..#.#.#.#.#.#..#
#.#.#.#.##.#.#.......#..##.##....####.#.#.##.#...#.......###.#..#.##.#..##...#..#...#..#.#.....#.#..#.##....####....#....#...#..#..#..#...........##.#
#........#.....#.#.#.##....##.##..##.........#.#...#.#.#.#....#.#..#.##....#...##.#..#.#.##.##....#......##...##.#.#..##...#...#..#..###.#.#.#.##....#
##.#.#.#...#.#...##....#.#.....##....#.#.#.#...#.#.........##....#...##.##...#.....#.....#...#.##...#.#.#...#....#..#....#...##..#..#.#....#.#....##.#
#.......#.#....#....##.....#.#....##.....#...#....##.#.#.#.#..##..##.....#.#...#.#...#.#...##.....#.....#.#..##.#..##.##..#.##..#..#....#.#....#.#.#.#
#.#.#.#...##.#...##.##.##.#...#.#....#.#..#.#..##....#.......####..#.##.#...##.#.#.#.#.#.#....#.#.#.##.#...#....#.##...##...##.#..##.##.....##.#.....#
#.......#..#.#.#......#.....#.....#.#..##.#.##...#.#...##.##.#####........#..#.#..........#.#.#.#........#...#.#...#.#...#.##..#.#.#.###.##......#.#.#
##.#.#.###.......#.##...##.#.##.#.....##.......#...#.#...#.#.####.#.#.###.##.....#.#.##.###......#.##.##...#.....#.#.#.#....#.#........#....#.##.....#
#...##.....#.#.##.....#.......####.##....#.#.#.#.#.....#..........##...#...#.#.#...#.....#..#.##.#.....#.##..#.#......##.###....#.####..#.#.#..#.#.#.#
#.#..##.#.##......#.#.#.##.##..##.....#.#..........#.#..#.#.#.#.#.#..#...#.#.##.##...#.#...#.......#.#......##..#.#.#..#.###.##.#..##.#......#...#...#
####.#.......#.##...#.#.....##....##.#..#.#.#.#.#.#...#.#...#....#..###.#..........#.#.##.##.#.#.#.####.##.#.##...#.##...........#......##.#...#...#.#
#......#.#.#...##.#.....#.#...#.#.#...#..##.#.....#.#.....#..##.#..#....#.#.#.#.##.#...............###.....#....#......##.#.##.#..##.#.#.....#.#.#...#
#.#.#.##...#.#.#...#.#.#...##...#...#..#....##.#.#...#.#.#.#......#.#.#...#.#.......#.##.#.##.#.##.....#.#...#.##.####..##...#..#...##...##.#......#.#
#........#...#...#...#.#.#..#.#...#..#.#.##..#.#.#.#.........#.##.....#.#.#...#.#.#................#.#.....#......###.#....#...##.#..#.####.#.##.#.#.#
##.#.#.#..#.#..##.##...#.##...##.##.##.....#..#.....##.#.###...#.##.#.......#....#..##.#.#.#.#.#.#...#.#.#..#.#.#.......##.###..#..#....###....#...#.#
#..###.##.....#......#......##.#.##...#.##.##...#.#.......##.#.#....#.#.##.#.#.#...###.....#.#...#.#.......##.#.#.##.##.#....##..#..#.#..##.##..#.#..#
##.###..#.#.#.#.#.##..#.##.##.......#...###...#...##.##.#...#...#.#..#...#.#....#.##...#.#.....#.#.##.#.##.#....#.#...#...##..##..#....#.#.....#....##
##..#.#.............#....#.#..##.##...#.....#.#.#.......#.#...#...##...#.....#.#.....#...#.##.##...##...##...##.....#..#.####...#.##.#..#..##.##.#.###
###....#.#.#.#.##.#...##....#.......#.#.##.#..=.##.#.##...#.##..#...##...#.#.#.#.#.#..##...#.....#.#..#....#.###.#.#..#...##..#...#...#...##.........#
##..##...#...#......#...#.#..##.#.#.#........#.##.....#.#......#..#.=..#...#......#.#....#...#.#.....#..##...#......##..#....##.#...#.#.#....##.#.##.#
#..#...#...#...#.##...#.#.##..#......#.#.#.#.#....#.#....##.#.#.##..#.#..#...#.#.#...#.#.##.#...#.#.###....#..#.#.#....#..####....#.....#.##...##....#
#.#.#.#.#.##.##...#.#......##...##.#.#......#..##..#.#.#...........#.#..###.##.....#..........#.........#.###.......##...#.....##...#.##..#..#....##.#
#...#...........#....#.#.#..#.#......#.####...##.#.....##.#.##.##.#....###..#..#.#...#.#.#.##..#.##.##.##.##..###.#...#.##.#.#.#..#.#....#..##.##....#
#.#...#.##.#.##...##......#.....##.#....##.##....#.#.#.##...........#.###..#..#...#.##.......#...##.......#..#....#.#....##......##.#.##...#.#....##.#
#.#.#.#.........#....##.#...#.#.##.####...=.#.#.#.........###.##.##.#..#..#.#.#.#.#.#..##.##.#.#.#..##.##...###.#..###.#.#..#.#.##......#.##...##.##.#
#.......#.#.###.#.##.##...#.........#.#.#.#...#...#.###.#........#...#...#............#...........#.....#.#......#..#......#.......##.#....#.#.#.....#
#.#.###.#...##....#.....#...##.##.#........##..#.##..#....#.#.#.#..#...#.###.#.###.#.#..#.#.#.#.#.#.#.#...#.##.#..#...#.####.#.#.#..#.####......##.#.#
#....#.#..#....#.#..#.#...#.#..#...#.#.###...#...###...##.....#...#.#.#...#...#........#.#....#.#.......#........#..#.............#....###.##.#......#
##.#....#..#.#.#...#....#.....#..#...#.###.#...#.#.#.#....#.#..#.#......#...#...#.###.#....##.....#.#.#..#.#.#.#...##.#.#.##.##.#...##..#.....#.#.##.#
#.#..##...###....#.#.##.#.#.#..#...##.......#.#......#.#.#...#.....##.#...#..#.##.##....#.###.#.#.....##.#.#.....#..#..........#..#..##...#.#...#....#
#...#...#.#...#.#....#...#....##.#....##.#.#..#.#.##......##...#.#......#.#.#......##.#...#......#.##...#...#.#.#.#...##.##.#.#..##.####.#..#.#...#.##
##.##.#.....#....###...#...#.#....#.#........#..#.#..#.##..#.#...#.##.#.......##.#....#.#...##.#.#.#..#...#.##......#....##.....#...###....#...#.##..#
#....##.###.##.#..#..#...###...##.#.#.#.#.#.#.#...##.....#.....#...#..#.#.#.#.....#.#.....#.###......#..#.#....##.#.##.#....#.#...#.##..#.#..#......##
##.#.....#......#..#..#.####.#..#.....#..#..#...#..#.#.#.#.###...#.##...##....#.#.....#.##......#.##.#.#...#.####....#...#.##...#.#....#....##.###.#.#
#...##.#...##.#..#..#.....#...#...#.#..#..#...#..#...#......#..#...###.#...##...#.#.#.#.#..#.#.##.#......#....###.###..#....##.##...##...##....###.#.#
#.#..#.#.#.##..#..#...#.#...#..#.#....#.#..=#..#..##...#.##..#...#.......#.##.#...........##.#..#...#.#.###.#..#...#..#.#.#....#..#...#.###.##..#....#
#...#.........###...#.....#..#.....##....#.#.#.##..#.#....##..##...#.#.##......#.#.###.##.....#..#.#....#.#.##...#...#....##.#...#..#.#.#.#.#.#...##.#
#.#...#.#.##.##...##..#.#..#...#.#.#..#.#.......##.....##...#....##.......####.....#....##.##..#.#.#.##.....###.###.##.##......#...#............#.##.#
#.#.#...#.#.....#....#...#...#...#...#....##.##....#.#...#.##.#.##..#.#.#.#...#.#.#..#.##...##.##...#...#.#......#.......##.#.#.#.#..###.#.#.#.#.....#
#...#.#.....#.#...##...#...#...#.#.###.##..#.###.#.....#..#.#......#..#.....##......##.#..#.#...#.##..##....#.##...#.#.#..#.........#..........#.#.###
#.#...##.#.#....#..##.#..##..#...#..#....#.........##.###...##.#.#...#..#.#..#.#.#.##....#....#...#..#...#.#...##.##....#...#.##.#.#..#.#.##.#.....###
#...#....#.#.#.#.#...#..#...##.#...#..#.#.#.#.#.##.###.#..#.....#..#.#.#...#..#.......##...#.#.##...##.#.....#.......##...#...##.....#.......#.#.#..##
#.#...#.#....#.....#...#..#.#....###.#..............#...#...#.#..##......#..#...#.#.#.##.#......##.#.....#.##..#.#.#....#...#..##.#.##.#.#.#..##.##..#
#...#...##.#...##.#.#.#.#.#...##..#...##.##.##.##.#...#..#.#...#....##.#...#.##.#......#.###.##.....#.##......#.....##.#.##..#....#.........#......#.#
#.#...#......#.##...#.......#.#.#...#....##.#......#.###..#..#..#.#.##.#.#....#...#.##....##.#..#.##.....#.#.###.##....#....#.#.#..#.##.#.#...#.##...#
#...#.##.#.#.#.#..#...#.###.....##.#..##......#.##......#...###.....#.....#.#..##...###.#.....##.....#.#..#....\#...##..#.#.#..##.##.##...#.#....##.##
#.#...#..........#.#.#..####.##..#.#.#...#.#.#..#..#.##.#.#..##.#.#...#.#....#..#.#..#....#.#....#.#....#...#.#..#.####.....##.......##.#..#.#.#.....#
#...#...#.##.#.#......#.####%..#......##.....##...#........#........#...#.##..#....#...##...#.##.##..##...#.#.##...#..#.#.#...##.###..#.##.#.#...#.#.#
#.#.#.#.........#.#.#....##..#.##.#.#....#.#....#.#.#.#.#.#.#.###.#.#.#..##.#..#.#...#.##.##......#.###.#......#.#...#....#.#.......#.#........#.....#
#.......##.##.#.#.##..##....#...#....#.#.#..#.#.....#...#.#....#.......#.....#.....##........##.#....#..##.#.#....#.##.##....#.#.##....##.#.####.#.#.#
#.#.#.#.#......#.....#...#.#..#...##......#.....#.#...#.....##..##.###...##.###.#.#...#.###.##...#.#...##.....#.#...##.###.#.##....#.#..#...####.#.#.#
#...#.....#.##...##.#.#.#....#.#.#.#.#.##..##.#..#..#...##.#..#....####.#...##..#.##.#...##....#.#.#.#....#.#.#...#.#...#..#....##.#.##...#..###.....#
#.#...##.##....#....#.#...#.#...........##.....#...##.####...#..##..####..##...#.......#....##.##....#.##......##.##..#...#..##..##.....#...#####.##.#
#.#.#.##....##.##.#.#...#.#...#.#.#.#.#....#.#.#.#.........#...#...####..#...#...##.#.##.##.......#.#.....##.#.......#..#...#.##....#.#...#.####...#.#
#......#.##..........#.#....#....#......#.#......#.#.#.#.#.#.#...#......###.#..#.##.#.......#.#.#.....###..#...#.#.#..#...#.....#.#.####.#.......#...#
##.#.#......####.###...#.#.###.#...#.#.#...#.#.#.....#.........#..#.#.#.#.....#..#....#.##.##.....#.##...#...#...#..#...#...###.....####...#.#.#...#.#
##.....##.#.###.....#.#........#.#.#..#..#......#.#.#..##.#.#.#..#........#.#...#..##...#...#.#.#...#..#...#...#...#.#.#..#..###.##..#...#..##.#.#...#
#..##.#.........#.#.#.#.#.##.#...#...#..###.#.#...#.##..#.#.#...#..#.#.##.#...#..#.##.##..#.......#...####...###.#...#...#.#..#....#...#..#......#.#.#
#.#.#...#.##.#.#...............#..#.#..###......##...##......#.##.#.....#...#...#..#.....#..##.#.#..#....#.#.##..#.#..#.#...#...##.##.#.#..#.#.#...###
#.....#...###....##.##.#.#.#.#.##...##.....##.#.#..#...###.###.#....#.#...#...#...#..#.#...#.#...##..#.#........#...#.....#..#.###......#.##....##...#
#.#.#..##.#...#.#.#.#.............#...#.#.##......#..#..#........##.....#.#.#...#...#..#.#.....#...#.....###.##...#.#.#.#...#...##.#.##......##..#.#.#
#....#......#......#..#.#.##.#.##...#...=....##.#...#.#...#.#.#.#.#.#.#.......#..#.#..#...#.##...####.##.....##.#.#.#.##.##...#.........#.#.#..#...#.#
#.#.#.#.#.##.#.#.#...##..###......#...##.##.#.....#.....#...#.#.#...#...#.#.#...##.##.#.#.#....#...##....#.#.#..#...........#...#.#.#.#.#....#...#...#
#..................#.###...#.##.#...#.#.....##.##...#.#...#.......#...#...##..#.......#.#...##...#..##.#..#...#...##.##.#.#.#.###.....#..#.#...#.#.#.#
##.#.#.#.##.#####.#..#...#...##...#.....#.#....##.#.#.##.###.#.#.###.##.#....#..#.#.#.....#....#..#......#..#.#.##.#...........###.#.#..#...#.#......#
#.....#.....=......#...#...#....#...##.#....#.#...#...#......#...##.....##.#..#.#....#.##...##=##.##.#.#...#.......#.#.##.#.##..##.....#..#.....#.#.##
#.#.#...##.#.#.#.#...#...#...##...#.##...##.#...#...#.#.##.#...#....#.#..#.##....#.#.#.##.#.....#.#...#..#...#.##.#..#..#.#####....#.#..#...###.#.#..#
#...#.#.#..........#.#.#...#....#......#...#..#...#.#......#.#.##.#....#......##...#......#.#.#.....#...#..#.#..#...###.....#.#.##....#...#........#.#
#.#.......#.#.#.##....#..#..#.#...#.#.#..#..#.#.#.#...##.##....##.##.####.#.#....#...##.#.......##.#..#...#....#..#..#..#.#......##.#..#.#..#.#.##...#
#...#.###.#.#...#.#.#...###...#.#.......#.#.........#..#....##.......####...##.#...#.#....#.###......#..#...##.#.###..#....##.##.##.##...#.#.....#.#.#
##.#...#......#...#...#.....##...##.#.#.....#.##.#.#.#..##.#.#.#.###.###..#....#.###...#.#...#.#.#.#...#..#.......###...##.....#....##.#.....#.#...#.#
#...##=..#.#.#..#...#.#.#.#....#..###...#.#...##......#....#......#...#..#..##....#.#.##.#.#...#.#..#.#..#..#.#.#.#...#..#.#.#..#.#..#...#.#...#.#...#
#.#....#=.....#..#.#.......#.#.##..##.#.#...#....###.#.#.#...##.#...#...###.##.##...#........#....##..#.#..#....##..#...#......##..#...#...#.#.....###
##.#.#...##.#...#....#.#.#......##....#..##.##.#..#.....##.#......#.##.#.#......#.#...#.##.#.#.##....#...#...##....#..#...#.##....##.#...#...#.#.#...#
#......#..#.##.##.#.#.....##.##....##..#........#...#.#....#.#.#.#.....#...#.##.....#.............#.#..#.##.#.##.#..#...#....#.##....#.#...##..#...#.#
#.##.#..#.......#.##..###......#.#....##.#.#.##..#.#....##.....##..###...#......#.#.##.##.#.#.###.....#...#.......#...###.#.#..#.#.#...#.#.#..#..#...#
#.#...#...#.#.#......###..###.#....##..........#....##.###.#.#....#.###.#..#.##......#........##.##.##..#...##.###..#..#.....#....#..#.......#.#.##.##
##..#...#...#.##.#.#.#.##...#...##...#.##.#.##.##.#.....#......##.#..#....#....#.#.#...#.#.##..........#..#.##.##..###=..#.#..#.#...###.##.#......#.##
#..#..#...#........#......#...#..#.#......#....#....#.##..#.#.#.#...#..##.#.#.##.....#.#...##.#.#.#.#.##.#........#.#..#.....#....#.........#.#.#....#
##...##.#..#.##.##..#.#.#...#..#.....##.#.#.##.#.#.#.....##.......#...###.#.#.#..#.#.....#.#....#......#.#.#.##.#.....##.###...##.#.#.##.##.......##.#
#..#.....#.#.#....#.#.....#.##...#.#.##.....##...#...#.#..#.#.#.#.#.#.##........#...##.#.#...##...##.#............#.#.#......#.............#.#.#.#.#.#
#.#..#.#...#...#.##...##.#.....#........###....#...#.#.##.....##.........###.#.#..#..#.#...#..##.#.#...##.#.##.##....#..##.#...#.#.#.##.###...##.....#
#.#.#....#...#.####.#......#.#..#.#.#.####..##...#........#.#..#.#.#.#.#........#..#.#...###.#...#..#.##..#....###.#..#.....#.##...#.....#..#....#.#.#
#....##.####.....##..##.##....#........###.##..#...#.#.#.#...##....#...#.##.#.#...##...#..#....#..#...###...##..#...#..##.#...##.#..#.##...##.#.#....#
#.##.....###.#.#...#.......#.#.#.#.#.#.#......##.#....=#..##....#.#..#....#.#...#.##.#...##.#.###...#..#..#..##...#..#.#..#.#....##......#.##...##.#.#
#..##.##........##...###.#..#........#...##.#.#..##.##..#..#.##.....#..#.#....###.#..#.#..#.#.#...#..#...###..#.#...##..#.....##...##.##...#..#....#.#
##.......#.####....##.....#...#.#.##...#..#....#......#..#......#.#.##.#...#.#.#...#.....#......#...##.#..###...#.#..##...#.#....#..#....#...##.##...#
##.#.##.##...###.#....#.#..####......#..#...###..#.#.##.##.##.#.....##...#.......#..#.##...##.#.#.#.....#..##.#...##....#.....##.##...##...#.......#.#
#..........#..##...#.#.#.#..#.#.##.#..#...#.##..##.........#..#.#.#....#.##.#.##...##....###......#.###..#.##...#....##...##.#......#...#.#.##.#.#.#.#
##.##.#.##.##....#.......##........##...#......#...##.##.#..#...#..#.#.#...##....#.##.##.##..#.##......#....#.#..=#.#.#.#..##..##.#.#.##.....#.......#
##......#....#.#...##.##..#.#.#.##..##.##.#.##..#.#.....#.#...#..#.......#....#.#...#.#.....##....#.#.###.#.....#.#.....##....##......#..#.#.##.#.#.##
##.#.##...##...=##......#........##.#..#......#.....#.#.....#.##...##.#.###.#.....#.....#.#....##.....##....##.##.#.###....#.#.#.#.##...#.#..........#
#.......#####.#..#.#.#.###.#.#.#.#....#..#.##...#.#.....#.#......#.##.#.#...##.###..###.....#.####.##....##..#.#.....#..##.......#.###.##...##.#.#.#.#
#.#.##.#..##...#.....#.###.....#...#.#..##....#....##.#.....#.##.........##........###..#.#....###....##....##...#.#...#...##.#.#.........#..#.......#
#......##....#...#.##...###.##...#...#.#...#.#..##.....#.#.#.....#.###.#..#.#.#.##.##..#...#.#.....##....##....#.#...#.##.#.......#.#.#.#..#.##.#.##.#
##.#.#...#.#...#......#........#...#...#.#.#..#.##.#.#.......##.#..##...#.#.#....#....##.##....##.#..#.#.##.##.....#........##.##.#.....##...####....#
#......#.#.#.#...##.#...##.#.#.##.#..#......#......#...#.##.#.....###.#.#.....#.#..#.##.....##.....#.#........#.#.#.#.##.##...#.#...#.#.##.#..####.#.#
#.#.#.#........#.#....#.##.#...##...##.###.#.###.#...#.#......#.#.###.##..#.#.#...##....#.#....#.#.....#.##.#.#.#...........#.....#.#.#.....#...##...#
#.#.....##.#.#.....#.#.#.....#....#....###........#.#...#.##.##.#.##.....##.....#..#.##...##.##....#.#............##.##.###..#.#.#......#.#...#....#.#
#...##.###.##..#.#.......#.#.#.##...##.#...##.##.#....#....#.##...#..#.#....#.###.#..#..#....#..##.....##.#.#.#.#..........#.......##.#...###...#.#..#
#.#.#.........##..#.#.##...#.....#.##....#....##...#.#..#.#.....#...#....##...##...#...##.##...#.#.###....#..#...#.#.#.#.#.#.#.##.#...#.#.###.###.##.#
#.....#.#.#.#....##....#.#...##.#.....##..#.#....#.....#....#.#...#..##.#.#.#....#..##.##.###.##...##..##..#..#.###......#.#...#....#......#.........#
#.##.#.##.....##....##...#.#.##...#.##.##..###.#...#.#.#.##...#.#..#......#...#.#.#...........#..#....####.##....#..#.#.#....#...##..##.##...#.#.#.#.#
#..#.#....#.#...#.#.##.#........#.#.#...##...##..#...##...#.#...##..#.#.#...#.#....#.#.#.##.#...##.#.#.##....#.#...#..#...#.##.#..##....###.#...#....#
##.....#.#....#..#...#...##.#.#.......#....#....#..#....#.....#....#.....#.#....##...#...##...#....#......##..##.#..#...#.#....##....##.....#.#...##.#
###.##.....##.#.#..#...#....#...#.##.##.#=#..#.###...##...###...##...#.#..#.###.#..#...#...#.#..##...###.#.##.....#...#.....#.#...#.###.#.#.....#..#.#
##...#.#.#.#......#..#...##...##.....###....###...##.#.#.#....#.###.#...#....#....##.###.#.....##.##..#.......#.#..#.#.#.##.....#.#..#......#.#...#..#
#..#.....#...#.##..#...#..#.#....#.#..#..##.....#.........#.#....##...#...##...##....###.##.#.##....#...#.#.##...#.........#.#.#...#.##.#.#...##.#..##
#.#..#.#...##....#..#.###.....##.....#..#...#.#.#.###.#.#...#.#.###.#...#....#..#.##.............##..####......#.##.##.#.#...#...#......#.#.#.##.#.###
##..#...##....##..#..#.##.#.#.##.#.#.#.####.......###...#.#...........####.#...#.....##.#.#.#.##.###......#.#.#...#.##...#.#..#.##.##.#...#.#.......##
##.#..#....#.#######...............#........#.#.#..#..#.....##.##.##.####....#...##.###......##..####.#.#.......#......#....#...........#.....#.###..#
######################################################################################################################################################
