######################
#........###o=.......#
##.#\#.#..#..#.##.##.#
#.......#..#.......#.#
#.#.#.#..#...#.#%##..#
#......#.##.##...#..##
#.##.#....#....#...#.#
#.#...o##...##..#.#..#
#...#.#.#.#...#.....##
#.#.#=#...#.#...##.###
#.......#...#.#.....##
#.##.##.#.#....=#.#..#
#.........##.##...##.#
##=#.##.#..#..#.#....#
#........#o.#.....##.#
#.#.#.##..#..##.#.##.#
#...#.#.#..#.........#
#.#.....##...#.#.#.#.#
#...#.#....#.....#...#
#.##...#.#..o#.#...#.#
#....#.....#.....#...#
######################
