##################################################
#........=#.#..#.##.....#.###....##...#.##.#####.#
#.#.#.#.#....#......#.#....##.##....#.......###..#
#.#...#.##.#...##.#...##.#.#.....#.#..#.#.#..#..##
#..#.#..#....#...#..#........#.#.##..#....##...###
##....#...#.##.#...##.#.#.#.#..#....##.##.##.#.###
###.#...#......#.#....##.....#...#.#.......#.#.###
#.#.#.#..#.#.#....#.#....#.#..#.##...#.#.#.......#
#......#.....#.##.#...#.#...#.#...#.#......##.##.#
##.#.#..#.##...##...#.....#.#...#.....#.#.###.##.#
#.....#......#....#...#.##....#.##.##.#.=..#.....#
#.#.#..##.###..##..#.#.....##...##.#....##.#.###.#
#...##.....#..#..#.##..#.#....#......##.#...####.#
#.#....#.#...##.#.....#....##..##.##.##...#...#..#
#...#.#....#......#.#...##...#.......#..#.#.#..#.#
#.#.#...##...#.#.#....#..#.#...#.#.#...#....##...#
#...#.#....##......##...#....#.#....##...##....#.#
###.....#.#...#.##..#.#...#.##..#.#....##.#.#.#..#
###.##.#....#...#..#....#...###.....#.#....#....##
#........#.##.#..#...##.#.#.....#.#...##.#...#.#.#
#.#.#.##.#....##.#.####...##.##...#.#..#..#.#....#
##.......##.#...#...###.#..#..#.#....#..#....###.#
#..#.###....#.#...#..#...#..#.....##.##..#.##.#..#
#.#...##.#.#...#.#.##..#..#..##.#...#..#.......#.#
#.#.#........#...#....#..#.#......#...##.###.#...#
#....##%##.#...#..#.#.#.#....#.#.#..#....#.#..##.#
##.#.......#.#.#.##.......##.......#.#.#....#....#
#..##.##.#..........##.#.##..##.##.#.....##...#.##
##.....#..#.#.#.#.#..#.....#.##\#....#.#..##.#...#
#..#.#..#....#.....#...#.##.......##....#..#...#.#
##.#.#.###.#...#.#...#...#..#.#.###..#.###...#..##
#.#....###...#....##...#...##.#..###...#.=.#.##..#
#...##.....#...##....#...#......####.#...#...#..##
##.#...##.#..#....##...#...#.#.#.#.....#...#...###
#..##.###.#.#.###....##..#.#.#.....#.#...#...#..##
#.###..#....#....#.#....##..#..#.#####.#...##.#..#
#...#.##.##..#.#....#.#...#...#...####.#.#....##.#
#.#...##..#.#..##.#...#.#...#...#..###.....##....#
#...#...#.....##....#....##...#..#.#...###...#.#.#
#.#...#.#.#.#....##.#.##.#..#...#....#..##.#.#...#
#...#.....#...##.#.....#...##.#...##.##.....#..#.#
#.#..#.##...#......#.#...#....#.#.....##.#.###...#
#...#..#..#...##.#.#.##.#.#.##....#.#....#.##..#.#
#.##..#..#..#..#.....##........##....=##......#..#
#....#..#.#.##...#.#....##.#.####.#.#....#.##.##.#
#.##...#....#..#....#.#..##..###......##.........#
#....#..#.#..#.#.##.....####.#...#.#.#...#.#.#.#.#
###.#.#..##.#....##.##.#.##...##.#.#.#.#.#...#.#.#
###....#......##............#..............#.....#
##################################################
