#######################
#..........#....=.....#
#.###.####.#.####.###.#
#.###%####o#.####.###.#
#.......=.......o.....#
#.###.#.#######.#.###.#
#.....#....#....#.....#
#####.#### # ####.#####
#   #.#         #.#   #
#####.# ### ### #.#####
#    .  #     #  .    #
#####.# ####### #.#####
#   #.#         #.#   #
#####.# ####### #.#####
#..........#..........#
#.###.####.#.####.###.#
#.o.#.............#...#
###.#.#.#######.#.#.###
#.....#....#....#.....#
#=########.#\########.#
#.o.....=........=.=..#
#######################
