#######################
#..\...=...#.....%....#
#.###.####.#.####.###.#
#.###.####.#.####.###.#
#.....................#
#.###o#.#######.#.###.#
#...=.#....#....#.....#
#####.#### # ####.#####
#   #.#         #.#   #
#####.# ### ### #o#####
#    .  #     #  .    #
#####.#=####### #.#####
#   #.#         #.#   #
#####.# ####### #.#####
#...o......#=.........#
#.###.####.#.####.###.#
#...#.=....=......#..o#
###.#.#.#######.#.#.###
#.....#....#....#.....#
#.########.#.########.#
#.....................#
#######################
