#######################
#.=........#..........#
#.###.####o#.####.###.#
#.###.####.#.####.###.#
#.........=...........#
#.###.#.#######.#.###.#
#....%#....#..o.#.....#
#####=#### # ####.#####
#   #.#         #.#   #
#####.# ### ### #.#####
#    .  #     #  .    #
#####.#=####### #o#####
#   #.#         #.#   #
#####.# ####### #.#####
#.........=#.......\..#
#.###.####.#.####.###.#
#...#.........o...#...#
###.#.#.#######.#.#.###
#.....#....#....#.....#
#.########.#.########.#
#.................=...#
#######################
