#######################
#..........#..........#
#.###.####.#.####.###.#
#.###.####o#.####.###.#
#.....................#
#.###.#.#######.#.###.#
#.....#....#....#...o.#
#####.#### # ####.#####
#   #\#         #.#   #
#####.# ### ### #.#####
#    .  #     #  .    #
#####.# ####### #.#####
#   #.#  =      #.#   #
#####.# ####### #.#####
#..........#.=........#
#.###.####.#.####.###.#
#...#.....%.......#...#
###.#.#.#######.#.#.###
#.....#....#....#.....#
#.########.#.########.#
#.....................#
#######################
