#######################
#..........#...==.....#
#.###.####.#.####.###.#
#.###.####.#.####.###.#
#..................=..#
#.###.#.#######.#.###.#
#.....#....#....#.....#
#####.#### # ####.#####
#   #.#        %#.#   #
#####.# ### ### #.#####
#    .  #     #  .    #
#####.#=####### #.#####
#   #.#         #.#   #
#####.# ####### #.#####
#...o...=..#.....o.o..#
#.###.####.#\####.###.#
#...#=............#...#
###.#.#.#######.#.#.###
#.....#....#....#.....#
#.########.#.########.#
#..........o..........#
#######################
