#######################
#..........#...o=.....#
#.###.####.#.####.###.#
#.###.####.#.####.###.#
#.....................#
#.###.#.#######.#.###.#
#.....#....#....#.....#
#####.#### # ####.#####
#   #.#        %#.#   #
#####.# ### ### #.#####
#    .  #     #  .    #
#####.# ####### #.#####
#   #.#         #.#   #
#####.# ####### #.#####
#.......o..#.......\..#
#.###.####.#.####.###.#
#...#=............#...#
###.#.#.#######.#.#.###
#.....#....#....#.....#
#.########.#.########.#
#.....................#
#######################
