#######################
#..........#..........#
#.###.####.#.####o###.#
#.###.####.#.####.###.#
#.....................#
#.###.#.#######.#.###.#
#.....#....#o\..#.....#
#####.#### # ####.#####
#   #.#         #.#   #
#####.# ### ### #.#####
#    .  #     #  .    #
#####.# ####### #=#####
#   #.#         #.#   #
#####.# ####### #.#####
#..........#..........#
#.###.####.#.####.###.#
#...#.............#...#
###%#.#.#######.#.#.###
#.....#..=.#....#.....#
#.########.#.########.#
#.....................#
#######################
