#######################
#..........#..........#
#.###.####.#.####.###o#
#.###.####=#.####.###.#
#.....................#
#.###.#.#######.#.###.#
#.....#....#....#.o.o.#
#####.#### # ####.#####
#   #o#         #.#   #
#####.# ### ### #.#####
#    .  #     #  .    #
#####.# ####### #.#####
#   #.#  =  =   #.#   #
#####.# ####### #.#####
#..........#.=.....\..#
#.###.####.#.####.###.#
#...#.....%.......#...#
###.#.#.#######.#.#.###
#.....#....#....#.....#
#.########.#.########.#
#.....................#
#######################
