#######################
#.o........#..........#
#.###.####.#.####.###.#
#.###.####.#.####.###.#
#.........o...........#
#.###.#.#######.#.###.#
#....%#....#....#.....#
#####\#### # ####.#####
#   #.#         #.#   #
#####.# ### ### #.#####
#    .  #     #  .    #
#####.# ####### #.#####
#   #.#         #.#   #
#####.# ####### #.#####
#.........=#..........#
#.###.####.#.####.###.#
#...#.............#...#
###.#.#.#######.#.#.###
#.....#....#....#.....#
#.########.#.########.#
#.................=...#
#######################
