#######################
#...o.o....#..........#
#.###.####.#.####=###.#
#.###.####.#.####.###.#
#.....................#
#.###.#.#######.#.###.#
#.....#....#=o..#.....#
#####.#### # ####.#####
#   #.#         #.#   #
#####.# ### ### #.#####
#    .  #     #  .    #
#####.# ####### #=#####
#   #.#         #.#   #
#####.# ####### #.#####
#..........#..........#
#.###.####.#.####.###.#
#...#o............#...#
###%#.#.#######.#.#.###
#.....#..=.#...\#.....#
#.########.#.########.#
#.....................#
#######################
