#######################
#.o.=......#..........#
#.###.####.#.####.###\#
#.###.####.#.####.###.#
#........=............#
#.###.#.#######.#.###.#
#.....#...%#....#.....#
#####o#### # ####.#####
#   #.#         #.#   #
#####.# ### ### #.#####
#    .  #     #  .    #
#####.# ####### #.#####
#   #.#         #.#   #
#####.# ####### #.#####
#..........#..........#
#.###.####.#.####.###.#
#.=.#....o........#...#
###.#.#.#######=#.#.###
#o....#..=.#....#.....#
#.########.#.########.#
#......=..............#
#######################
