#######################
#..\...=...#.....%....#
#.###.####.#.####.###.#
#.###.####.#.####.###.#
#.....................#
#.###o#.#######.#.###.#
#...=.#....#....#.....#
#####.#### # ####.#####
#   #.#         #.#   #
#####.# ### ### #o#####
#    .  #     #  .    #
#####.# ####### #.#####
#   #.#         #.#   #
#####.# ####### #.#####
#..........#=.........#
#.###.####.#.####.###.#
#...#.=....o......#..o#
###.#.#.#######.#.#.###
#.....#....#....#.....#
#.########.#.########.#
#.....................#
#######################
