#######################
#.%....=...#.=........#
#=###.####.#.####.###.#
#.###.####.#.####.###.#
#......o..............#
#.###o#.#######.#.###.#
#.....#....#....#.....#
#####.#### # ####.#####
#   #.#         #.#   #
#####\# ### ### #.#####
#    .  #     #  .    #
#####.# ####### #.#####
#   #.#         #.#   #
#####.# ####### #.#####
#..........#...o....o.#
#.###.####.#.####.###.#
#...#.............#...#
###.#.#=#######.#.#.###
#.....#....#....#.=..=#
#.########.#.########.#
#.....................#
#######################
