#######################
#..........#..........#
#.###.####.#.####.###.#
#.###%####.#.####.###.#
#.......o.............#
#.###.#.#######.#.###.#
#.....#....#....#.....#
#####.#### # ####.#####
#   #.#         #.#   #
#####.# ### ### #.#####
#    .  #     #  .    #
#####.# ####### #.#####
#   #.#         #.#   #
#####.# ####### #.#####
#..........#..........#
#.###.####.#.####.###.#
#...#.............#...#
###.#.#.#######.#.#.###
#.....#....#....#.....#
#\########.#.########.#
#.......=........=.o..#
#######################
