#######################
#.o........#..........#
#.###.####.#.####.###o#
#.###.####=#.####.###.#
#.....................#
#.###.#.#######.#.###.#
#.....#....#....#.o.=.#
#####.#### # ####.#####
#   #=#         #.#   #
#####.# ### ### #.#####
#    .  #     #  .    #
#####.# ####### #.#####
#   #.#  =  =   #.#   #
#####.# ####### #.#####
#..........#.=.....o..#
#.###.####.#.####.###.#
#...#.....%.......#...#
###.#.#.#######.#\#.###
#.....#....#....#.....#
#.########.#.########.#
#.....................#
#######################
