#######################
#.%....=...#.o........#
#o###.####.#.####.###.#
#.###.####.#.####.###.#
#......o..............#
#.###.#.#######.#.###.#
#.....#....#....#.....#
#####.#### # ####.#####
#   #.#         #.#   #
#####.# ### ### #.#####
#    .  #     #  .    #
#####.# ####### #.#####
#   #.#         #.#   #
#####.# ####### #.#####
#..........#...o....\.#
#.###.####.#.####.###.#
#...#.............#...#
###.#.#=#######.#.#.###
#.....#....#....#.=..=#
#.########.#.########.#
#.....................#
#######################
