#######################
#.=........#..........#
#.###.####.#.####.###.#
#.###.####.#.####.###.#
#.........o...........#
#.###.#.#######.#.###.#
#....%#....#..o.#.....#
#####o#### # ####.#####
#   #.#         #.#   #
#####.# ### ### #.#####
#    .  #     #  .    #
#####.#=####### #\#####
#   #.#         #.#   #
#####.# ####### #.#####
#.........=#..........#
#.###.####.#.####.###.#
#...#.........o...#...#
###.#.#.#######.#.#.###
#.....#....#....#.....#
#.########.#.########.#
#.................=...#
#######################
