#######################
#...=.o....#.........\#
#.###.####.#.####=###.#
#.###.####.#.####.###.#
#.....................#
#.###.#.#######.#.###.#
#.....#....#==..#.....#
#####.#### # ####.#####
#   #.#         #.#   #
#####.# ### ### #.#####
#    .  #     #  .    #
#####.# ####### #=#####
#   #.#         #.#   #
#####.# ####### #.#####
#..........#..........#
#.###.####.#.####.###.#
#...#o............#...#
###%#.#.#######.#.#.###
#.....#..=.#...o#.....#
#.########.#.########.#
#.......o.............#
#######################
