#######################
#..........#....o.....#
#.###.####.#.####.###.#
#.###%####o#.####.###.#
#.......=.......o.....#
#.###.#.#######.#.###.#
#.....#....#....#.....#
#####.#### # ####.#####
#   #.#         #.#   #
#####.# ### ### #.#####
#    .  #     #  .    #
#####.# ####### #.#####
#   #.#         #.#   #
#####.# ####### #.#####
#..........#..........#
#.###.####.#.####.###.#
#.\.#.............#...#
###.#.#.#######.#.#.###
#.....#....#....#.....#
#o########.#.########.#
#.......=........=.=..#
#######################
