#######################
#.o.=......#..........#
#.###.####.#.####.###\#
#.###.####.#.####.###.#
#........o............#
#.###.#.#######.#.###.#
#.....#...%#....#.....#
#####o#### # ####.#####
#   #.#         #.#   #
#####.# ### ### #.#####
#    .  #     #  .    #
#####.# ####### #.#####
#   #.#         #.#   #
#####.# ####### #.#####
#..........#..........#
#.###.####.#.####.###.#
#.=.#.............#...#
###.#.#.#######=#.#.###
#.....#..=.#....#.....#
#.########.#.########.#
#......o..............#
#######################
