#######################
#...o......#..........#
#.###.####.#.####.###.#
#.###.####.#.####.###.#
#........\............#
#.###.#.#######.#.###.#
#.....#...%#....#.....#
#####.#### # ####.#####
#   #.#         #.#   #
#####.# ### ### #.#####
#    .  #     #  .    #
#####.# ####### #.#####
#   #.#         #.#   #
#####.# ####### #.#####
#..........#..........#
#.###.####.#.####.###.#
#.=.#.............#...#
###.#.#.#######=#.#.###
#.....#..o.#....#.....#
#.########.#.########.#
#.....................#
#######################
