#######################
#..........#...==.....#
#.###.####.#.####.###.#
#.###.####.#.####.###.#
#..................o..#
#.###.#.#######.#.###.#
#.....#....#....#.....#
#####.#### # ####.#####
#   #.#        %#.#   #
#####.# ### ### #.#####
#    .  #     #  .    #
#####.# ####### #.#####
#   #.#         #.#   #
#####.# ####### #.#####
#...o...=..#.....o.o..#
#.###.####.#.####.###.#
#...#=............#...#
###.#.#.#######.#.#.###
#.....#....#....#.....#
#.########.#.########.#
#..........\..........#
#######################
