#######################
#........=.#..........#
#.###.####.#.####.###.#
#.###\####.#.####.###.#
#..o..................#
#.###.#.#######.#.###.#
#.....#....#....#..%..#
#####.#### # ####.#####
#   #.#         #.#   #
#####.# ### ### #.#####
#    . =#     #  .=   #
#####.# ####### #.#####
#   #.#         #.#   #
#####=# ####### #.#####
#.........o#..........#
#.###o####.#.####.###.#
#...#.............#...#
###.#.#.#######.#.#.###
#..o..#....#....#.....#
#.########.#.########.#
#.....................#
#######################
