#######################
#%.........#......o...#
#.###.####.#.####.###.#
#.###.####.#.####.###.#
#..o......=...........#
#.###.#.#######.#.###.#
#.....#....#....#...\.#
#####.#### # ####.#####
#   #.#         #.#   #
#####.# ### ### #.#####
#    .  #     #  .    #
#####.# ####### #.#####
#   #.#        =#.#   #
#####.# ####### #.#####
#..........#..........#
#.###.####.#.####.###.#
#...#.............#...#
###.#.#.#######.#.#.###
#.....#....#....#....o#
#.########.#.########.#
#........=...o.=......#
#######################
