#######################
#........o.#..........#
#.###.####.#.####.###.#
#.###.####.#.####.###.#
#..\..................#
#.###.#.#######.#.###.#
#.....#....#....#..%..#
#####.#### # ####.#####
#   #.#         #.#   #
#####.# ### ### #.#####
#    . =#     #  .    #
#####.# ####### #.#####
#   #.#         #.#   #
#####=# ####### #.#####
#..........#..........#
#.###.####.#.####.###.#
#...#.............#...#
###.#.#.#######.#.#.###
#..o..#....#....#.....#
#.########.#.########.#
#.....................#
#######################
