#######################
#........=.#..........#
#.###.####.#.####.###.#
#.###o####.#.####.###.#
#..o..................#
#.###.#.#######.#.###.#
#.....#....#....#..%..#
#####.#### # ####.#####
#   #.#         #.#   #
#####.# ### ### #.#####
#    . =#     #  .=   #
#####.# ####### #.#####
#   #.#         #.#   #
#####=# ####### #.#####
#.........o#.......\..#
#.###=####.#.####.###.#
#...#.o...........#...#
###.#.#.#######.#.#.###
#..=..#....#....#.....#
#.########.#.########.#
#.....................#
#######################
