#######################
#%.........#..........#
#.###.####.#.####.###.#
#.###.####.#.####.###.#
#..\......o...........#
#.###.#.#######.#.###.#
#.....#....#....#.....#
#####.#### # ####.#####
#   #.#         #.#   #
#####.# ### ### #.#####
#    .  #     #  .    #
#####.# ####### #.#####
#   #.#        =#.#   #
#####.# ####### #.#####
#..........#..........#
#.###.####.#.####.###.#
#...#.............#...#
###.#.#.#######.#.#.###
#.....#....#....#.....#
#.########.#.########.#
#........o.....=......#
#######################
