#######################
#......o...#.....%....#
#.###.####.#.####.###.#
#.###.####.#.####.###.#
#.....................#
#.###.#.#######.#.###.#
#...=.#....#....#.....#
#####.#### # ####.#####
#   #.#         #.#   #
#####.# ### ### #.#####
#    .  #     #  .    #
#####.# ####### #.#####
#   #.#         #.#   #
#####.# ####### #.#####
#..........#=.........#
#.###.####.#.####.###.#
#...#.o...........#..\#
###.#.#.#######.#.#.###
#.....#....#....#.....#
#.########.#.########.#
#.....................#
#######################
