#######################
#%.........#......o...#
#.###.####.#.####.###.#
#.###o####.#.####.###.#
#..=......=...........#
#.###.#.#######.#.###.#
#.....#....#....#...o.#
#####.#### # ####.#####
#   #.#         #.#   #
#####.# ### ### #.#####
#    .  #     #  .    #
#####.# ####### #.#####
#   #.#        =#.#   #
#####.# ####### #.#####
#..........#..........#
#\###.####.#.####.###.#
#...#.............#...#
###.#.#.#######.#.#.###
#.....#....#....#....o#
#.########.#.########.#
#........=...=.=......#
#######################
